"filename", "language", "C#", "XML", "Markdown", "comment", "blank", "total"
"c:\Users\super\source\repos\TechMod\README.md", "Markdown", 0, 0, 73, 0, 29, 102
"c:\Users\super\source\repos\TechMod\TechMod.Tests\GlobalUsings.cs", "C#", 1, 0, 0, 0, 0, 1
"c:\Users\super\source\repos\TechMod\TechMod.Tests\Mocking\FakeClasses\FakeApplicationCommandInteractionData.cs", "C#", 19, 0, 0, 0, 5, 24
"c:\Users\super\source\repos\TechMod\TechMod.Tests\Mocking\FakeClasses\FakeDiscordInteraction.cs", "C#", 71, 0, 0, 0, 25, 96
"c:\Users\super\source\repos\TechMod\TechMod.Tests\Mocking\FakeClasses\FakeGuild.cs", "C#", 410, 0, 0, 0, 137, 547
"c:\Users\super\source\repos\TechMod\TechMod.Tests\Mocking\FakeClasses\FakeMessage.cs", "C#", 99, 0, 0, 3, 50, 152
"c:\Users\super\source\repos\TechMod\TechMod.Tests\Mocking\FakeClasses\FakeMessageChannel.cs", "C#", 115, 0, 0, 0, 26, 141
"c:\Users\super\source\repos\TechMod\TechMod.Tests\Mocking\FakeClasses\FakeReaction.cs", "C#", 14, 0, 0, 0, 2, 16
"c:\Users\super\source\repos\TechMod\TechMod.Tests\Mocking\FakeClasses\FakeRole.cs", "C#", 50, 0, 0, 0, 21, 71
"c:\Users\super\source\repos\TechMod\TechMod.Tests\Mocking\FakeClasses\FakeSlashCommandInteraction.cs", "C#", 19, 0, 0, 0, 5, 24
"c:\Users\super\source\repos\TechMod\TechMod.Tests\Mocking\FakeClasses\FakeUser.cs", "C#", 55, 0, 0, 0, 20, 75
"c:\Users\super\source\repos\TechMod\TechMod.Tests\Mocking\FakeClasses\FakeUserMessage.cs", "C#", 53, 0, 0, 2, 14, 69
"c:\Users\super\source\repos\TechMod\TechMod.Tests\Mocking\README.md", "Markdown", 0, 0, 4, 0, 1, 5
"c:\Users\super\source\repos\TechMod\TechMod.Tests\TechMod.Tests.csproj", "XML", 0, 25, 0, 0, 6, 31
"c:\Users\super\source\repos\TechMod\TechMod.Tests\Tests\DatabaseTests.cs", "C#", 11, 0, 0, 0, 2, 13
"c:\Users\super\source\repos\TechMod\TechMod.Tests\Tests\General\BotSystemTests.cs", "C#", 39, 0, 0, 0, 8, 47
"c:\Users\super\source\repos\TechMod\TechMod.Tests\Tests\TestSamples\Vote\TestVote.cs", "C#", 32, 0, 0, 0, 6, 38
"c:\Users\super\source\repos\TechMod\TechMod.Tests\Tests\UtilTests.cs", "C#", 19, 0, 0, 0, 5, 24
"c:\Users\super\source\repos\TechMod\TechMod.Tests\Tests\Votes\VoteTests.cs", "C#", 92, 0, 0, 1, 17, 110
"c:\Users\super\source\repos\TechMod\TechMod\Actions\Clear\ClearAction.cs", "C#", 51, 0, 0, 0, 6, 57
"c:\Users\super\source\repos\TechMod\TechMod\Actions\Clear\ClearModule.cs", "C#", 54, 0, 0, 0, 3, 57
"c:\Users\super\source\repos\TechMod\TechMod\Actions\Clear\ClearVote.cs", "C#", 51, 0, 0, 0, 11, 62
"c:\Users\super\source\repos\TechMod\TechMod\Actions\Lock\LockAction.cs", "C#", 153, 0, 0, 2, 33, 188
"c:\Users\super\source\repos\TechMod\TechMod\Actions\Lock\LockModule.cs", "C#", 49, 0, 0, 0, 2, 51
"c:\Users\super\source\repos\TechMod\TechMod\Actions\Lock\LockVote.cs", "C#", 39, 0, 0, 0, 7, 46
"c:\Users\super\source\repos\TechMod\TechMod\Actions\Mute\MuteUserAction.cs", "C#", 30, 0, 0, 0, 4, 34
"c:\Users\super\source\repos\TechMod\TechMod\Actions\Mute\MuteUserModule.cs", "C#", 64, 0, 0, 0, 2, 66
"c:\Users\super\source\repos\TechMod\TechMod\Actions\Mute\MuteUserVote.cs", "C#", 55, 0, 0, 0, 10, 65
"c:\Users\super\source\repos\TechMod\TechMod\Attributes\DoUserCheckAttribute.cs", "C#", 26, 0, 0, 7, 5, 38
"c:\Users\super\source\repos\TechMod\TechMod\Attributes\RequireOwnerAttribute.cs", "C#", 26, 0, 0, 0, 1, 27
"c:\Users\super\source\repos\TechMod\TechMod\Attributes\Title.cs", "C#", 17, 0, 0, 0, 2, 19
"c:\Users\super\source\repos\TechMod\TechMod\Classes\Behaviors\VoteAction.cs", "C#", 26, 0, 0, 0, 8, 34
"c:\Users\super\source\repos\TechMod\TechMod\Classes\Triggers\VoteMenu.cs", "C#", 236, 0, 0, 17, 45, 298
"c:\Users\super\source\repos\TechMod\TechMod\Classes\Util\BotSystem.cs", "C#", 36, 0, 0, 0, 8, 44
"c:\Users\super\source\repos\TechMod\TechMod\Classes\Util\BotSystemManager.cs", "C#", 23, 0, 0, 0, 3, 26
"c:\Users\super\source\repos\TechMod\TechMod\Classes\Util\Utils.cs", "C#", 25, 0, 0, 0, 7, 32
"c:\Users\super\source\repos\TechMod\TechMod\Config.cs", "C#", 22, 0, 0, 0, 3, 25
"c:\Users\super\source\repos\TechMod\TechMod\Data\CardDB.cs", "C#", 126, 0, 0, 2, 25, 153
"c:\Users\super\source\repos\TechMod\TechMod\InteractionHandler.cs", "C#", 64, 0, 0, 10, 11, 85
"c:\Users\super\source\repos\TechMod\TechMod\MainModule.cs", "C#", 156, 0, 0, 5, 43, 204
"c:\Users\super\source\repos\TechMod\TechMod\Migrations\20231013055452_InitialCreat.Designer.cs", "C#", 59, 0, 0, 2, 20, 81
"c:\Users\super\source\repos\TechMod\TechMod\Migrations\20231013055452_InitialCreat.cs", "C#", 52, 0, 0, 3, 6, 61
"c:\Users\super\source\repos\TechMod\TechMod\Migrations\InfoDBModelSnapshot.cs", "C#", 57, 0, 0, 1, 20, 78
"c:\Users\super\source\repos\TechMod\TechMod\Program.cs", "C#", 57, 0, 0, 3, 18, 78
"c:\Users\super\source\repos\TechMod\TechMod\TechMod.csproj", "XML", 0, 33, 0, 0, 8, 41
"Total", "-", 2653, 58, 77, 58, 690, 3536